29 28
19 17 
1 1    1    1 1 1 1 1 1 1 1 1 1 1 1 1    1    1    1    1 1 1 1 1 1 1 1 1 
1 1002 1200 1 1 1 1 1 0 0 0 0 0 0 0 0    0    0    0    0 0 0 0 0 0 0 0 1
1 1300 1401 1 1 1 2 0 0 0 0 0 0 0 0 0    0    199  0    0 0 0 0 0 0 0 0 1
1 1500 0    1 1 2 2 0 0 0 0 0 0 0 0 0    199  1201 199  0 0 0 0 0 0 0 0 1
1 299  1    1 1 2 2 0 0 0 0 0 0 0 0 0    0    199  0    0 0 0 0 0 0 0 0 1
1 150  1    2 2 2 0 0 0 0 0 0 0 0 0 0    0    0    0    0 0 0 0 0 0 0 0 1 
1 149  1    2 1 0 0 0 0 0 0 0 0 0 0 0    0    0    0    0 0 0 0 0 0 2 2 2
1 299  1    1 1 1 1 0 0 0 0 0 0 0 0 0    0    0    0    0 0 0 0 2 2 2 2 2
1 0    0    1 1 1 1 1 1 1 0 0 0 0 0 0    0    0    2    2 2 0 2 2 2 2 2 2 
1 0    0    0 1 1 1 1 1 1 1 0 0 0 0 0    0    0    2    2 2 0 2 2 2 2 2 2
1 0    0    1 1 1 2 2 2 1 1 0 0 0 0 0    0    2    2    2 2 0 2 2 2 2 2 2
1 0    0    1 1 2 2 2 2 0 1 1 0 0 0 0    0    0    2    2 2 0 2 2 2 2 2 2
1 1    0    0 1 1 2 2 2 1 1 1 0 0 0 0    2    2    2    2 2 0 2 2 2 2 2 2
1 1    1    0 0 0 1 2 2 1 1 1 1 0 0 0    2    2    2    2 2 0 2 2 2 2 2 2
1 1    1    1 0 0 0 1 1 1 1 1 0 0 0 0    2    2    1301 2 0 0 2 2 2 2 2 2
1 1    1    1 0 0 1 1 1 1 0 0 0 0 0 0    2    2    0    0 0 0 2 2 2 2 2 2
1 1    1    0 0 1 1 1 1 1 1 0 0 0 0 0    2    2    2    2 2 2 2 2 2 2 2 2
1 0    1    1 0 1 1 1 1 0 0 0 0 0 0 0    0    2    2    2 2 2 2 2 2 2 2 2
1 0    1    1 0 1 1 1 0 0 0 0 0 0 0 0    0    0    2    2 2 2 2 2 2 2 2 2
1 0    1    0 0 0 1 0 0 0 0 0 0 0 0 0    0    0    0    2 2 2 2 2 2 2 2 2
1 0    0    0 0 0 0 0 0 0 0 0 0 0 0 0    0    0    0    0 0 0 2 2 2 2 2 2
1 0    0    0 0 0 0 0 0 0 0 0 0 1 1 111  201  0    0    0 0 0 0 2 2 2 2 2
1 1    0    0 0 0 0 0 0 0 0 0 0 0 0 0    0    0    0    0 0 0 0 0 2 2 2 2   
0 1    1    1 0 0 0 0 0 0 0 0 0 0 0 0    0    0    0    0 0 0 0 0 0 2 2 2
0 0    0    1 1 0 0 0 0 0 0 0 0 0 0 0    0    0    0    0 0 0 0 0 2 2 2 2
0 0    0    0 1 1 1 1 0 0 0 0 0 0 0 0    0    0    0    0 0 0 0 2 2 2 2 2
0 0    0    0 0 0 0 1 1 0 0 0 0 0 0 0    0    0    0    0 0 0 0 2 2 2 2 2
0 0    0    0 0 0 0 1 1 1 0 0 0 0 0 0    0    0    0    0 0 0 0 0 2 2 2 2
0 0    0    0 0 0 1 1 1 1 1 1 1 1 1 1    1    1    1    1 1 1 1 1 2 2 2 2